//1,2,3,4,5,6,7,8,9,10
1,1,1,1,1,1,1,1,1,1
1,0,0,0,0,5,4,0,0,1
1,4,2,0,0,3,4,2,0,1
1,4,0,0,0,3,4,0,0,1
1,0,0,3,3,3,3,0,0,1
1,0,0,0,0,0,0,0,0,1
1,4,0,4,0,0,0,0,0,1
1,4,0,4,0,2,0,0,0,1
1,4,0,0,0,4,0,0,0,1
1,1,1,1,1,1,1,1,1,1
