//1,2,3,4,5,6,7,8,9,10
1,1,1,1,1,1,1,1,1,1
1,0,0,0,0,5,0,0,0,1
1,0,0,0,0,3,0,0,3,1
1,0,0,0,3,3,3,3,3,1
1,0,3,3,3,3,3,3,0,1
1,0,0,0,3,OK,0,0,3,1
1,0,0,0,3,0,3,0,0,1
1,0,3,0,0,0,3,0,0,1
1,0,0,3,3,0,3,0,0,1
1,1,1,1,1,1,1,1,1,1
