//1,2,3,4,5,6,7,8,9,10
1,1,1,1,1,1,1,1,1,1
1,0,0,0,0,0,0,0,0,1
1,2,0,0,0,3,0,0,2,1
1,0,0,0,0,3,0,0,0,1
1,0,0,0,0,3,0,0,0,1
1,3,4,0,4,p,3,3,0,1
1,3,0,2,4,0,0,3,0,1
1,3,0,4,0,4,0,3,0,1
1,3,0,0,0,0,0,3,5,1
1,1,1,1,1,1,1,1,1,1
