//1,2,3,4,5,6,7,8,9,10
1,1,1,1,1,1,1,1,1,1
1,0,5,0,10,0,2,0,0,1
1,0,2,0,0,0,0,0,0,1
1,0,0,4,4,4,4,0,0,1
1,3,3,4,0,0,4,0,0,1
1,0,0,6,0,0,4,0,0,1
1,0,0,4,4,4,4,9,0,1
1,0,7,0,0,0,0,0,0,1
1,0,0,0,8,2,0,0,0,1
1,1,1,1,1,1,1,1,1,1
